###############
#•••F•••••••••#
##•##•#####•###
#•••••••••••••#
####•######•###
#•••••••••••••#
#•###•######•##
#•••••••••••••#
#•#######•###•#
#•••••••••••••#
#•#######•###•#
#•••••••••••••#
##•##•#####•###
#•••••••••P•••#
###############